0000000000000
9111111111200
0001000010000
0001000010000
0001000000200
0001111111118
0000000000000